1111111111111\n10010000000C1\n1000011111001\n1P0011E000001\n1111111111111